type octile
height 30
width 50
map
..................................................
........@.@..@@....@.@@.@.@.@.@@@.@.@.@.@.@.@.@@.@
...@..@.@.@......@.@.@@.@.@.@.....@.@.@.@.@.@.@@.@
...@..@.@.@..@@..@.@........@.@.@.@.@.@.@.........
...................@..@.@.@.@.@.@.@.....@.@@@....@
.@.@@@@.@.@.@@@.@@.@..@.@.@.@.@.@.@.@@@.@...@..@.@
.@......@.@........@......................@@@..@.@
.@..@.@.....@@.@.@.@.@@@@@@.@..@.@.@....@.........
.@..@.@..@@....@.@.@........@..@.@.@..@.@.@......@
.@....@......@.....@.@@@....@......@..@.@.@......@
.@.@@.@..@@..@.@@@.@.....@@.@.@@.@........@...@...
.....................@.@....@.@@.@.@@.@.@.@...@.@@
.@@@@@@@@@@@@@@@.@@@.@.@..@.@......@@.@.@.........
.................@@@.@.@..@.@.@@@@.@@.@.@..@@@....
.@@@@@@@@@@@@@@@.@@@.............................@
.....................@..@.@@.@@.@@@.@.@.@..@.@...@
..@@.......@.........@..@.......@@@.@.@.@..@.@....
.....@@@@@.@..@@...@.@....@@.@@.@@@........@.@.@.@
..@@.......@.......@.@..@...........@@@@@......@.@
......@@.@.@..@@.@@@.@..@.@@.@@..@@........@@@.@.@
.@@@.....@..........................@@............
.......@.@.@.@.@.@.@.@..@..@..@..@@.@@..@.@@@@@@@@
.@@@...@.@.@.@.@.@.@.@..@..@..@.....@@..@.........
.................@.@.@..........@.@.......@@.@.@.@
.@.@......@@.@@@.....@.@@.@@.@@.@.@.@@.@@....@.@.@
.@.@..@.@........@.@.@.....................@.@....
......@.@..@.@.@.@.@.@.@@@@@.@@.@@@..@..@..@.@.@@@
.@@@..@.@..@.@.@.....................@..@.........
.................@.@..@@@.@@@@.@@.@.......@.@.@@.@
.@@@.@@@@.@@.@@@.@.@..@@@.@@@@.@@.@.@@@@@.@.@.@@.@
