type octile
height 95
width 260
map
....................................................................................................................................................................................................................................................................
....................................................................................................................................................................................................................................................................
....................................................................................................................................................................................................................................................................
....................................................................................................................................................................................................................................................................
....................................................................................................................................................................................................................................................................
....................................................................................................................................................................................................................................................................
.......................##################...........................................................................................................................................................................................................................
......................###################...........................................................................................................................................................................................................................
.....................####..##############...........................................................................................................................................................................................................................
...................#####............####....................#......................#######################..........................................................................................................................................................
..................#####....................................###...................#########################.........#.##################...........................##................................................................................................
.................#####....................................####....................########################........#####################..........................###................................................................................................
................#####.....................................###...........................###......................####.....#############..........................####...............................................................................................
...............#####.....................................####...........................###......................###.............................................####...........##..................................................................................
..............#####.....................................####............................####....................####.............................................####...........###......####.......................................................................
.............#####.....................................#####............................####....................####.............................................####...........###......####.......................................................................
.............#####.....................................####.............................####...................#####.............................................####...........###......####.......................................................................
............##################........................#####.............................####...................####..............................................####...........###.....####........................................................................
............########################..................####..............................###...................####...###.........................................####...........####...#####........................................................................
...........#####.....##################..............#####..............................###...................######################.............................####...........####...####.........................................................................
...........####............############..............####..............................####..................#######################.............................####...........###...####..........................................................................
...........####..................######..............####..............................####..................####......#############............................####...........####..####...........................................................................
...........####......................##..............####..............................####..................####...............................................####...........####.####............................................................................
...........####......................................####..............................####..................#####..............................................####...........####.###.............................................................................
...........####......................................####..............................####...................####..............................................####...........####.##..............................................................................
...........####......................................####..............................####...................######............................................####...........####.#####...........................................................................
...........#####.....................................####..............................####....................#######..........................................####..........#####..######.........................................................................
............#####....................................####..............................####.....................##########.......##.............................####..........#####....#####........................................................................
.............######..................................#####.............................####......................###################............................####..........#####.....#####.......................................................................
..............#######................................###################...............####.........................################............................####..........#####......######.....................................................................
...............########...............................####################.............####............................############.............................####..........#####.......######....................................................................
................############...........................###################.....................................................................................#####..........#####.........#####...................................................................
..................###################.....................###############.......................................................................................####...........###...........######.................................................................
.....................##################.......................................................................................................................................................#####.................................................................
........................##############.........................................................................................................................................................###..................................................................
..................................###...............................................................................................................................................................................................................................
....................................................................................................................................................................................................................................................................
....................................................................................................................................................................................................................................................................
....................................................................................................................................................................................................................................................................
....................................................................................................................................................................................................................................................................
....................................................................................................................................................................................................................................................................
......................................................................................................................................................................................................########......................................................
................................................................................................................................................................................................####################................................................
..............................................................................................................................................................................................########################..............................................
.............................................................................................................................................................................................##########################.............................................
.......................#####........................................................................................................................................###########.............######...............#######............................................
....................###########..................................................................................................................................#################.........#####...................######...........................................
...................#############............................................................######..............................................................#####################......####.....................#####...........................................
..................#####....#####......................#.................................#############.........................................................########.......#########....#####......................#####..........................................
...................##.......#####...................###...............................#################....................#..................................#####.............########..####.......................#####..........................................
.............................####.................############.......................########....#######...................##................................#####.................###########........................####..........................................
.............................####...............#################....................###...........######.................###.............##.................#####...................########.........................####..........................................
.............................####...............####################.................##.............#####.................####............###................####.....................#######.........................####..........................................
.............................####..............######..###############...............................#####................####............###................####......................######.........................####..........................................
.............................####..............#####..........##########..............................####................####............###................#####.......................####.........................####..........................................
............................#####.............#####..............########.............................#####...............####............###................#####........................###.........................####..........................................
............................####..............####..................######............................#####...............####...........####.................####.........................###.......................#####..........................................
...........................#####..............####...................#####............................#####...............####...........####.................#####.........................#.......................######..........................................
..........................#####...............####....................#####...........................#####...............####...........####..................#####................................................#####...........................................
.........................#####................####.....................####..........................#####................#####........######..................#####...............................................#####............................................
........................#####.................####.....................####..........................#####.................#######....######....................#####.............................................#####.............................................
................############..................####.....................####.........................#####...................################.....................#####..........................................######..............................................
..............###############.................#####...................#####........................#####.....................###############......................######.......................................######...............................................
.............##################................#####..................#####.......................######.......................#############.......................######.....................................######................................................
.............###################...............#####.................#####......................#######.................................####........................######...................................######.................................................
.............###########..########..............######..............######.................###########..................................#####........................######.................................######..................................................
..............########......########.............######...........#######...............################.................................####.........................#######..............................######...................................................
..............................#########...........#######.......########..............#####################..............................####...........................######............................######....................................................
...............................########............###################.................##########.##############.........................####............................#######.........................######.....................................................
.................................######..............################...................######.......################....................####.............................########......................######......................................................
....................................###................############.....................................#############....................####..............................#########...................#####........................................................
...........................................................#####............................................#########....................####................................########.................#####.........................................................
.........................................................................................................................................####..................................########.............######..........................................................
.........................................................................................................................................####....................................########..........######...........................................................
...................................................................................................................................................................................#######.........#####............................................................
....................................................................................................................................................................................########......#####.............................................................
......................................................................................................................................................................................#######....#####..............................................................
........................................................................................................................................................................................######..######..............................................................
..........................................................................................................................................................................................#####.#####...............................................................
...........................................................................................................................................................................................#########................................................................
...........................................................................................................................................................................................#########................................................................
............................................................................................................................................................................................#######.................................................................
............................................................................................................................................................................................#######.................................................................
.............................................................................................................................................................................................######.................................................................
....................................................................................................................................................................................................................................................................
....................................................................................................................................................................................................................................................................
....................................................................................................................................................................................................................................................................
....................................................................................................................................................................................................................................................................
....................................................................................................................................................................................................................................................................
....................................................................................................................................................................................................................................................................
....................................................................................................................................................................................................................................................................
....................................................................................................................................................................................................................................................................
....................................................................................................................................................................................................................................................................
....................................................................................................................................................................................................................................................................
....................................................................................................................................................................................................................................................................
